(0 0 0) (0 0 0) (0 0 0) (0 0 0) (1 2 0) (1 2 0) (1 2 0) (0 0 0) (0 0 0) (0 0 0) (0 0 0)
(0 0 0) (0 0 0) (0 0 0) (1 2 0) (1 2 0) (1 2 0) (1 2 0) (1 2 0) (0 0 0) (0 0 0) (0 0 0)
(0 0 0) (0 0 0) (0 0 0) (1 2 0) (1 2 0) (1 2 0) (1 2 0) (1 2 0) (0 0 0) (0 0 0) (0 0 0)
(0 0 0) (0 0 0) (1 2 0) (1 2 0) (1 3 0) (1 2 0) (1 3 0) (1 2 0) (1 2 0) (0 0 0) (0 0 0)
(0 0 0) (0 0 0) (1 2 0) (1 2 0) (1 4 0) (1 2 0) (1 4 0) (1 2 0) (1 2 0) (0 0 0) (0 0 0)
(0 0 0) (0 0 0) (1 2 0) (1 2 0) (1 2 0) (1 2 0) (1 2 0) (1 2 0) (1 2 0) (0 0 0) (0 0 0)
(0 0 0) (0 0 0) (1 2 0) (1 2 0) (1 2 0) (1 2 0) (1 2 0) (1 2 0) (1 2 0) (0 0 0) (0 0 0)
(0 0 0) (0 0 0) (1 2 0) (1 2 0) (1 2 0) (1 2 0) (1 2 0) (1 2 0) (1 2 0) (0 0 0) (0 0 0)
(0 0 0) (0 0 0) (1 2 0) (1 2 0) (1 2 0) (1 2 0) (1 2 0) (1 0 0) (1 2 0) (0 0 0) (0 0 0)
(0 0 0) (0 0 0) (1 2 0) (1 2 0) (1 0 0) (1 0 0) (1 0 0) (1 2 0) (1 2 0) (0 0 0) (0 0 0)
(0 0 0) (0 0 0) (0 0 0) (1 2 0) (1 2 0) (1 2 0) (1 2 0) (1 2 0) (0 0 0) (0 0 0) (0 0 0)
(0 0 0) (0 0 0) (0 0 0) (1 2 0) (1 2 0) (1 2 0) (1 2 0) (1 2 0) (0 0 0) (0 0 0) (0 0 0)
(0 0 0) (0 0 0) (0 0 0) (0 0 0) (1 2 0) (1 2 0) (1 2 0) (0 0 0) (0 0 0) (0 0 0) (0 0 0)
(0 0 0) (0 0 0) (0 0 0) (0 0 0) (0 0 0) (0 0 0) (0 0 0) (0 0 0) (0 0 0) (0 0 0) (0 0 0) 
(0 0 0) (0 0 0) (0 0 0) (0 0 0) (0 0 0) (0 0 0) (0 0 0) (0 0 0) (0 0 0) (0 0 0) (0 0 0) 
